NO ./greystone.xpm
SO ./purplestone.xpm
WE ./redbrick.xpm
EA ./wood.xpm

F 77,92,53
C 163,208,230

1111111111111111111111111111111111111
1000000000000000000000000000000000001
1000000000000000000000000000000000001
1000000000000000000000000000000000001
1000000000000000000000000000000000001
1000000000000000000000000000000000001
1111111111111111111111111111111111111
